3. 24. VI. 1932. Oрелецький Bасиль — Jужани на Буковинi.
4. 16. XII. 1932.
Tищенко Стефан — с. іщани на Полтав-
щинi.
Bатран Iван — Дунаïв в Галичинi.
Горбачевcький IBан — honoris causa.
Хитьков Oлександер — м. Kозятин на По-
діллi.
Poсоха Cтефан — Драгово на Закарпаттi.
Kолеccа Oлекcандeр — honoris causa.
Сiмяцький Трохим — Чижiв на Городнен-
щинI.
Kорець Антонiн — Подебради в Чехiï.
Мацейович Oлеr — м. Стрий B Галичинi.
Kир Iван — с. Kоманочi в Галичинi.
Постоленкo Cергiй — M. Cуми на Харкiвщинi.
BOJOIиH ABTVCTиH — honoris causa.
Петрашевcький Дем'ян — Михайловцi на
Поділлi.
Теняк Павло — с. Kоролево над Tисою на
Закарпаттi.
Штефанець Юрій — с. Доманинцi на За-
KарпаvTi.
Сокол Рудольф — Плзень в Чехiï.
Лисий Eвген — с. Kоmляки в Галичинi.
Бачинський Bасилько — м. Париж.
Kралик Iван — с. Доманинцi на Закарпаттi
Старосольський Юрій — M. JьBIB.
Падох Ярослав — M. Бучач в Галичинi.
Площанський Остап — Гошiв B Галичинi.
Падох народж. Гермак Iрена — м. CяніK
у Галичинi.
Глинка Роман — м. KолOмия, в Галичинi.
Мороз Ярослав — M. JbBIB.
Герич Юрій — с. Дуліби B Галичинi.
ПопиK Богдан — с. Синевідсько Hижне
B Галичинi.
Дубас Лев — M. JьBiB.
Kуник Олександер — м. Перемишль в Гали-